1111111
1220221
1212121
1212121
1212121
1222221
1111111